county,murder,rape,robbery,assault,burglary,larceny,auto theft,total,population
Anderson County,20,153,98,890,1511,3271,447,6390,57500
Andrews County,3,84,21,359,370,1491,200,2528,18508
Angelina County,18,237,239,1211,3702,9420,937,15764,87485
Aransas County,12,130,57,734,2088,4826,366,8213,32674
Archer County,0,7,1,31,34,95,18,186,3472
Armstrong County,0,4,1,12,40,43,14,114,1904
Atascosa County,20,63,70,542,1552,4762,658,7667,50416
Austin County,3,47,29,233,589,1123,178,2202,29846
Bailey County,1,8,3,53,148,353,41,607,7037
Bandera County,1,65,5,89,558,875,156,1749,22202
Bastrop County,27,295,215,1144,1836,5556,740,9813,85918
Baylor County,0,8,1,42,79,170,26,326,3570
Bee County,10,19,32,383,872,2232,110,3658,32767
Bell County,167,1496,1679,4532,10545,33619,4169,56207,348258
Bexar County,825,8908,13537,45824,71777,356443,46313,543627,1972257
Blanco County,2,16,4,82,162,257,56,579,11522
Borden County,0,2,0,8,23,39,8,80,651
Bosque County,1,3,1,59,262,349,31,706,16627
Bowie County,27,348,359,1901,3107,11010,1133,17885,93622
Brazoria County,49,709,696,2417,5602,26331,2500,38304,369691
Brazos County,38,895,646,2556,4993,24075,1886,35089,224101
Brewster County,5,18,1,78,231,286,35,654,9190
Briscoe County,0,2,0,3,14,25,8,52,1496
Brooks County,1,1,3,100,346,478,3,932,7160
Brown County,6,171,56,573,1122,3846,265,6039,37824
Burleson County,2,43,16,144,334,638,60,1237,17466
Burnet County,5,175,29,475,926,2534,297,4441,48575
Caldwell County,6,63,52,405,697,1980,221,3424,41582
Calhoun County,9,93,20,430,685,1240,149,2626,19521
Callahan County,2,8,6,71,326,426,91,930,13801
Cameron County,45,1211,1379,6000,10857,53793,2087,75372,423935
Camp County,6,27,15,149,357,715,124,1393,12897
Carson County,2,6,3,127,91,152,29,410,5961
Cass County,4,86,37,385,1084,1796,229,3621,29685
Castro County,1,7,3,55,227,405,60,758,7607
Chambers County,14,92,75,484,828,3314,493,5300,37318
Cherokee County,13,135,68,771,1595,3408,468,6458,51754
Childress County,0,3,0,16,45,66,16,146,3086
Clay County,3,31,8,58,239,352,101,792,10294
Cochran County,0,4,1,19,87,147,22,280,2840
Coke County,1,0,0,8,42,22,15,88,3290
Coleman County,1,17,5,87,188,118,20,436,5367
Collin County,80,1715,1458,3933,10175,60523,4752,82636,966516
Collingsworth County,0,0,0,17,16,12,1,46,1986
Colorado County,4,33,27,196,389,876,171,1696,21065
Comal County,25,416,201,1552,2642,9518,1195,15549,155973
Comanche County,8,21,9,123,360,909,53,1483,13434
Concho County,0,0,0,32,28,19,7,86,3649
Cooke County,8,130,69,477,859,2624,250,4417,39128
Coryell County,10,112,117,929,1298,4896,269,7631,75658
Cottle County,1,0,0,10,8,8,2,29,878
Crane County,2,7,0,18,33,93,21,174,4939
Crockett County,1,1,3,23,176,78,13,295,3604
Crosby County,0,3,3,22,106,70,19,223,4875
Culberson County,0,0,0,0,0,0,0,0,2185
Dallam County,2,41,8,226,407,845,94,1623,9954
Dallas County,1372,7895,33699,45402,95363,328655,83406,595792,2899477
Dawson County,5,54,26,228,634,1526,149,2622,12765
DeWitt County,4,81,9,472,740,1347,101,2754,17325
Deaf Smith County,0,26,51,410,562,1633,202,2884,18720
Delta County,0,1,0,11,77,71,6,166,5266
Denton County,59,1874,1075,3384,7527,40493,4350,58762,647855
Dickens County,0,1,1,22,42,15,11,92,2171
Dimmit County,1,8,2,48,211,690,48,1008,10715
Donley County,2,2,3,17,64,143,26,257,3336
Duval County,1,12,11,221,282,504,165,1196,11290
Eastland County,5,65,7,184,510,946,126,1843,17362
Ector County,79,665,937,6225,5715,22716,4343,40680,164974
Edwards County,1,2,0,8,31,53,7,102,1898
El Paso County,176,2392,2488,12409,8966,63707,5350,95488,841211
Ellis County,22,265,277,1042,2499,10624,1132,15861,166777
Erath County,4,155,25,286,782,2535,171,3958,42190
Falls County,2,13,29,118,217,300,79,758,14064
Fannin County,2,87,25,233,666,1292,135,2440,31763
Fayette County,4,64,25,271,466,1147,110,2087,25214
Fisher County,0,0,1,44,74,76,9,204,3173
Floyd County,1,22,7,129,158,296,35,648,5767
Foard County,0,0,0,0,1,2,0,3,682
Fort Bend County,107,1149,1696,5471,8776,41467,3279,61945,739020
Franklin County,5,23,2,76,181,207,34,528,9970
Freestone County,2,18,19,161,485,737,107,1529,19641
Frio County,3,7,22,184,801,1111,125,2253,19626
Gaines County,4,24,7,182,335,846,127,1525,20943
Galveston County,117,1373,1283,3026,8005,35329,4266,53399,347699
Garza County,0,23,1,47,98,154,17,340,6419
Gillespie County,6,11,7,71,192,967,55,1309,26581
Glasscock County,0,0,1,8,41,64,16,130,1359
Goliad County,2,14,6,86,166,327,45,646,7606
Gonzales County,3,96,17,552,419,1193,103,2383,20481
Gray County,4,56,49,589,1063,3538,277,5576,22510
Grayson County,36,406,279,1407,3233,9273,1344,15978,128500
Gregg County,74,509,611,2065,5121,17569,2075,28024,131764
Grimes County,10,55,42,279,743,1218,227,2574,28081
Guadalupe County,23,468,193,938,2502,10218,845,15187,147547
Hale County,1,59,39,337,987,3116,234,4773,32380
Hall County,1,2,4,44,60,59,12,182,2992
Hamilton County,0,10,4,62,134,345,38,593,6926
Hansford County,0,4,0,33,36,53,21,147,5466
Hardeman County,2,0,0,10,65,90,12,179,3762
Hardin County,13,73,40,405,943,2495,502,4471,56764
Harris County,2536,13361,76016,123097,165783,656872,124937,1162602,4707136
Harrison County,22,106,143,937,2144,4794,627,8773,64819
Hartley County,1,0,0,3,37,31,14,86,3045
Haskell County,0,4,4,30,77,110,41,266,5771
Hays County,42,722,425,1753,3365,15337,1659,23303,216973
Hemphill County,0,12,1,30,31,129,17,220,4082
Henderson County,19,379,98,913,2903,4222,816,9350,79375
Hidalgo County,163,2526,2152,9669,18784,100783,5277,139354,856036
Hill County,7,70,45,260,864,2612,226,4084,34643
Hockley County,7,139,38,629,971,2205,209,4198,23248
Hood County,10,104,34,429,912,4030,309,5828,57727
Hopkins County,14,80,42,232,356,1109,228,2061,36601
Houston County,3,9,14,260,542,1214,113,2155,22719
Howard County,16,72,121,1039,1603,5396,737,8984,36818
Hudspeth County,0,1,0,18,39,46,16,120,4213
Hunt County,25,275,219,1628,2181,5841,950,11119,89206
Hutchinson County,2,125,26,235,922,2063,248,3621,19735
Irion County,1,3,0,10,35,104,13,166,1530
Jack County,2,18,4,79,158,378,88,727,8800
Jackson County,2,33,19,97,284,713,73,1221,14899
Jasper County,8,153,38,503,1267,2686,357,5012,34798
Jeff Davis County,3,4,0,14,24,24,6,75,2202
Jefferson County,156,875,2676,7546,11851,30459,3585,57148,253571
Jim Hogg County,0,4,1,28,43,43,11,130,5184
Jim Wells County,8,128,49,1083,2583,5058,385,9294,39390
Johnson County,20,507,192,1869,2851,10590,1317,17346,175688
Jones County,8,11,14,105,324,570,90,1122,14220
Karnes County,3,16,15,188,518,1277,110,2127,15280
Kaufman County,22,335,215,964,2526,7417,1224,12703,124354
Kendall County,1,87,22,155,768,2262,280,3575,42503
Kenedy County,0,4,0,10,8,14,15,51,410
Kent County,0,1,3,10,15,35,1,65,753
Kerr County,16,157,28,449,758,3331,214,4953,51802
Kimble County,1,2,2,25,50,90,17,187,4352
King County,0,0,0,0,3,1,0,4,187
Kinney County,0,0,1,5,22,3,3,34,1944
Kleberg County,8,90,76,613,1259,4075,183,6304,31288
Knox County,0,12,2,28,143,124,12,321,3742
La Salle County,0,3,5,48,40,215,5,316,7754
Lamar County,10,145,149,1136,1606,4451,378,7875,49504
Lamb County,2,47,14,224,433,829,117,1666,12649
Lampasas County,2,36,5,133,390,1529,81,2176,18757
Lavaca County,4,45,13,182,563,769,58,1634,22521
Lee County,3,59,23,159,194,928,72,1438,16265
Leon County,1,6,2,91,445,656,78,1279,15856
Liberty County,29,277,131,1160,1878,5812,1043,10330,74284
Limestone County,3,59,43,296,729,1678,144,2952,23406
Lipscomb County,3,3,1,19,25,58,19,128,3452
Live Oak County,2,8,9,98,241,347,52,757,9827
Llano County,2,15,4,87,324,642,64,1138,16158
Loving County,0,0,0,3,6,64,5,78,137
Lubbock County,97,1420,2707,12275,16109,54708,7384,94700,303596
Lynn County,2,3,1,20,107,134,49,316,5358
Madison County,0,22,27,166,383,690,85,1373,14086
Marion County,5,19,15,238,394,470,70,1211,9959
Martin County,1,11,4,43,94,385,46,584,5799
Mason County,0,3,0,21,46,69,11,150,4177
Matagorda County,20,148,122,638,1601,4798,240,7567,36670
Maverick County,8,32,50,416,1520,4389,329,6744,58407
McCulloch County,1,5,2,45,216,457,60,786,8073
McLennan County,66,1085,967,4446,8314,31293,2512,48683,248547
McMullen County,0,0,0,3,40,91,3,137,796
Medina County,11,160,42,514,1055,3359,424,5565,48564
Menard County,0,0,1,5,19,10,0,35,2120
Midland County,40,297,381,2236,3302,15543,2318,24117,168086
Milam County,7,33,20,251,628,1472,130,2541,24720
Mills County,0,2,0,29,56,74,6,167,4877
Mitchell County,1,3,5,52,272,467,44,844,8548
Montague County,0,28,23,213,566,1143,123,2096,18406
Montgomery County,86,968,1100,4171,8442,33615,4500,52882,573623
Moore County,4,53,8,221,438,1518,218,2460,21781
Morris County,6,32,18,199,332,740,91,1418,12411
Motley County,0,2,0,4,10,39,4,59,1181
Nacogdoches County,15,205,141,680,1574,5515,405,8535,65535
Navarro County,8,230,144,751,1550,4297,369,7349,47898
Newton County,4,7,3,95,232,238,63,642,11880
Nolan County,1,25,26,240,858,1357,117,2624,13521
Nueces County,175,1723,2875,11576,14310,56433,4930,92022,362995
Ochiltree County,0,17,0,163,206,526,66,978,10291
Oldham County,0,0,1,10,29,41,9,90,2097
Orange County,18,138,284,1170,2560,5559,1054,10783,83748
Palo Pinto County,2,42,30,191,937,2035,260,3497,28658
Panola County,9,49,30,321,681,2236,193,3519,23074
Parker County,14,293,90,777,2061,6650,721,10606,131571
Parmer County,1,11,3,56,140,226,49,486,9692
Pecos County,4,29,16,211,379,1008,102,1749,15891
Polk County,21,205,61,440,1406,3378,506,6017,48924
Potter County,84,1115,1574,6506,10014,36923,5858,62074,215454
Presidio County,0,5,0,36,35,69,23,168,5754
Rains County,0,14,0,77,162,302,59,614,11732
Randall County,5,159,34,259,624,1829,263,3173,39225
Reagan County,0,0,0,42,87,235,27,391,3803
Real County,0,2,0,26,102,160,17,307,3408
Red River County,2,17,5,136,320,384,52,916,11608
Reeves County,8,49,20,472,243,1236,133,2161,15330
Refugio County,0,4,3,63,105,204,34,413,7145
Roberts County,0,0,0,5,10,26,2,43,905
Robertson County,6,36,36,158,546,852,118,1752,16759
Rockwall County,6,177,72,345,707,5373,568,7248,91327
Runnels County,2,12,6,141,310,448,45,964,10320
Rusk County,12,119,52,887,1625,4490,505,7690,50313
Sabine County,3,24,4,138,301,345,83,898,9594
San Augustine County,2,15,3,109,172,135,48,484,8262
San Jacinto County,1,142,14,139,1118,1225,352,2991,28180
San Patricio County,16,117,79,834,1552,5148,457,8203,58637
San Saba County,4,7,1,56,137,156,33,394,5869
Schleicher County,0,1,0,11,57,110,8,187,2946
Scurry County,1,37,9,369,501,1165,60,2142,17156
Shackelford County,0,1,3,13,30,52,16,115,3292
Shelby County,11,55,19,322,690,1527,146,2770,24249
Sherman County,0,4,1,7,22,24,11,69,2718
Smith County,69,657,612,3266,6764,24308,2524,38200,227865
Somervell County,2,11,4,42,147,192,16,414,8900
Starr County,12,102,55,746,1000,2531,478,4924,64395
Stephens County,2,23,5,72,234,605,55,996,9440
Sterling County,0,0,1,9,10,19,6,45,1359
Stonewall County,0,0,0,12,9,10,1,32,1371
Sutton County,0,11,1,16,46,118,14,206,3803
Swisher County,0,25,19,201,185,554,44,1028,6932
Tarrant County,626,6607,11169,29799,51300,242547,31980,374028,2004920
Taylor County,38,695,641,2365,5278,17455,1616,28088,142736
Terrell County,2,0,0,2,11,18,4,37,547
Terry County,3,28,11,170,345,709,172,1438,12569
Throckmorton County,0,1,3,10,20,8,3,45,1528
Titus County,8,153,77,521,908,3067,217,4951,32704
Tom Green County,30,588,251,1484,4706,18573,1742,27374,119043
Travis County,250,4835,6702,18067,34661,188887,18680,272082,1290144
Trinity County,2,13,6,78,239,412,82,832,12160
Tyler County,10,62,19,325,764,576,184,1940,21399
Upshur County,12,71,36,520,1000,1678,229,3546,37307
Upton County,0,4,1,20,14,86,9,134,3667
Uvalde County,7,57,41,291,766,3642,144,4948,27107
Val Verde County,7,74,62,292,1152,3790,205,5582,48935
Van Zandt County,5,56,16,203,919,1752,200,3151,53696
Victoria County,34,457,334,1556,3625,11018,880,17904,92674
Walker County,10,252,168,1003,1230,3957,555,7175,71962
Waller County,14,232,142,701,1139,2758,323,5309,50811
Ward County,3,49,19,286,470,1213,132,2172,11850
Washington County,4,122,61,464,684,1980,197,3512,35171
Webb County,58,800,960,3907,5457,32631,1475,45288,272188
Wharton County,10,103,102,706,1163,3900,362,6346,41529
Wheeler County,0,1,3,24,72,160,20,280,4832
Wichita County,36,620,687,1492,5133,16955,1734,26657,131758
Wilbarger County,1,49,25,203,354,1232,99,1963,12746
Willacy County,6,108,37,744,972,2125,85,4077,21127
Williamson County,32,1089,573,2203,5884,32905,1942,44628,506351
Wilson County,6,46,18,217,758,1582,230,2857,49264
Winkler County,4,12,4,79,215,442,84,840,7954
Wise County,15,143,29,513,793,2725,356,4574,66429
Wood County,4,137,19,281,856,1765,230,3292,45169
Yoakum County,0,19,0,31,131,336,40,557,8625
Young County,5,46,19,120,356,761,84,1391,18033
Zapata County,1,2,9,71,161,311,12,567,7112
Zavala County,1,18,10,182,550,673,57,1491,16866
